19 73 4
XXXXXXXXXXXXXXXXXXXXXXXXXXXXXXXXXXXXXXXXXXXXXXXXXXXXXXXXXXXXXXXXXXXXXXXXX
XXX                                                                     X
XXX XXXXXXXXXXXXXXXXXXXXXXXXXXXXXXXXXXXXXXXXXXXXXXXXXXXXXXXXXXXXXXXXXXX X
XXX XXXXXXXXXXXXXXXXXXXXXXXXXXX       XXXXXXXXXXXXXXXXXXXXXXXXXXXXXXXXX X
XXX                                                                   X X
XXXXXXXX XXXXXXXXXXXX XXXXXXXXXXXXXXXXXXXXXXXXXXXXXXXXXXXXXXXXXXXXXXXXX X
XXXXXXXX XXXXXXXXXXXX X                         XXXXXXXXXXXXXXXXXXXXXXX X
XXXXXXXX                XXXXXX XXXXXXXXXXXXXXX XXXXXXXXXXXXXXXXXXXXXXXX X
XXXXXXXX XXXXXX XXXXXXXXXXXXXX XXXXXXXXXXXXXXX XXXXXXXXXXXXXXXXXXXXXXXX X
XXXXXXXX XXXXXX XXXXXXXXXXXXXX XXXXXXXXXXXXXXX X                        X
XXXXXXXX XXXXXX XXXXXXXXXXXXXX XXXXXXXXXXXXXXX XXXX XXXXXXXXXXXX XXXXXX X
X               XXXXXXXXXXXXXX         XXXXXXX XXXX XXXXXXXXXXXX XXXXXX X
X XXXXXXXXX XXXXXXXX       XXXXXXXXXXX XXXXXXX XXXX XXXXXXXXXXXX XX  XX X
X XXXXXXXXX XXXXXXXX XXXXX XXXXXXXXXXX XXXXXXX XXXX XXXXXXXXXXXX XXXXXX X
X XXXXXXXXX XXXXXXXX XXXXX XXXXXXXXXXX XXXX    XXXX XXXXXXXXXXXX XXXXXX X
X                                           XXXXXXX XXXXXXXXXXXX        X
XXXXXXXXXXXXXXXXXXXXXXXXXXXXXXXXXXXXXXXXXXXXXXXXXXX XXXXXXXXXXXXXX XXXXXX
X                                   XVX                                XX
XXXXXXXXXXXXXXXXXXXXXXXXXXXXXXXXXXXXXXXXXXXXXXXXXXXXXXXXXXXXXXXXXXXXXXXXX